12 15
............
............
..+..##..+..
..#......#..
............
............
..#......#..
..+..##..+..
..#......#..
............
............
..#......#..
..+..##..+..
............
............
4 3 5 3
2
Food 1
Hedg 1
Teleport 2
Pillow 3